R 1280 720

NO ./textures/turtle.xpm
SO ./textures/nemo.xpm
WE ./textures/crab.xpm
EA ./textures/jellyfish.xpm


H ./textures/seashell_pearl.xpm
h ./textures/bubble.xpm
M ./textures/octopus.xpm
C ./textures/underwater_sunshine.xpm
F ./textures/sand.xpm
S 0,60,190
w0 ./textures/trident_0.xpm
w1 ./textures/trident_1.xpm
w2 ./textures/trident_2.xpm
w3 ./textures/trident_3.xpm
w4 ./textures/trident_4.xpm
w5 ./textures/trident_5.xpm

  1111111111111111111111111
  10H0000000000000000000001
  10H000000000HM000000000H111
110000000000000000000000001
100E00000000000000000011111111111111111
11100000000000000011011111111
   10111111111011100000010001
   10111111111011100000000001
11100000110101011100000000001
1000M000000000001100000000001
10000000000000001100HHMMM0001
11100001100101011110000000001
1HH10111 10101000000000000001
10020101 11111111111111111111
1HH1111
1111
