R 600 400
NO ./path_to_the_north_texture
SO ./path_to_the_south_texture
WE ./path_to_the_west_texture
EA ./path_to_the_east_texture
S ./path_to_the_sprite_texture

F 255,0,0
C 225,30,0

1111111111111111111111111
1000000000010001000000001
1000000000010001002000001
1000000000000100000000001
100000000000000000000000100000001
100000000000000000110111111111111
11110111111111011100000010001
11110111111111011101010010001
110000001101N1011100000010001
10002000000000001100000010001
1000000000000000110101000001
1100000110010101111101111000111
11110111 1010101 101111010001
11111111 1111111 111111111111
