R 1600 900
NO ./textures/turtle.xpm
SO ./textures/nemo.xpm

WE ./textures/crab.xpm
EA ./textures/jellyfish.xpm
S ./textures/octopus.xpm

C 144,202,249  
F 255,183,77

1111111111111111111111111
1020000000000000000000001
1020000000000000000000021
1E00000000000000000000011
10000000000000000000001111111
10000000000000000011011111111
11100111111111011100000010001
11100111111111011100000000001
11000000110101011100222220001
10002000000000001100200020001
10000000000000001100220220001
11000001100101011110000000001
11110111 10101000000000000001
11010111 11111111111111111111
1111111
