R 1280 720
NO ./textures/turtle.xpm
SO ./textures/nemo.xpm
WE ./textures/crab.xpm
EA ./textures/jellyfish.xpm
S ./textures/seashell_pearl.xpm
C ./textures/underwater_sunshine.xpm
F ./textures/sand.xpm

1111111111111111111111111
1020000000000000000000001
1020000000000000000000021
1000000000000000000000011
10000000000000000000001111111
1S000000000000000011011111111
11100111111111011100000010001
11100111111111011100000000001
11000000110101011100000000001
10002000000000001100000000001
10000000000000001100220220001
11000001100101011110000000001
11110111 10101000000000000001
11010111 11111111111111111111
1111111
