R 1280 720
NO ./textures/turtle.xpm
SO ./textures/nemo.xpm
WE ./textures/crab.xpm
EA ./textures/jellyfish.xpm
S ./textures/octopus.xpm

F 255,0,0
C 225,30,0

1111111111111111111111111
1200000000000000000000001
10N0000000000000000000021
1000000000000000000000011
10000000000000000000001111111
10000000000000000011011111111
11100111111111011100000010001
11100111111111011100000000001
11000000110101011100000000001
10002000000000001100000200001
10000000000000001100000000001
11000001100101011110000000001
11110111 10101000000000000001
11111111 11111111111111111111
