R 1600 900
NO ./textures/turtle.xpm
SO ./textures/nemo.xpm
WE ./textures/crab.xpm
EA ./textures/jellyfish.xpm
S ./textures/void.xpm

F 255,0,0
C 225,30,0

1111111111111111111111111
1000000000000000000000001
1000000000000000000000021
1W00000000000000000000021
100000000000000000000000100000001
100000000000000000110111111111111
11110111111111011100000010001
11110111111111011100000000001
11000000110101011100000000001
10002000000000001100000100001
10000000000000001100000000001
1100000110010101111000000000111
11110111 1010101 100000000001
11111111 1111111 111111111111
